1 5 0 0 0 0 0 0 0
0 0 0 0 0 0
0 2 0 0 0 0
0 0 0 0 0 0
0 0 0 0 2 0
0 0 0 0 0 0
0 0 5 1 1 0 0 0
0 0 0 0 0 0
2 2 0 0 0 0
0 0 0 0 0 0
0 0 0 0 0 3
0 5 1 0 0 0 2 2
0 0 0 0 0 0
0 0 0 0 0 0
0 0 2 5 2 0 0 0
0 0 0 0 0 0
0 0 0 0 0 0
0 0 2 2 2 0
0 0 0 0 0 0
0 0 0 0 0 3
5 1 0 0 2 0 0 0
0 0 0 0 0 0
2 2 0 0 0 0
0 0 0 5 1 1 0 0
0 0 0 2 0 0
0 5 2 1 0 0 0 0
0 0 0 0 0 0
0 0 0 0 0 0
0 0 2 2 0 0
0 0 0 0 0 0
0 2 0 0 2 0
0 2 0 0 2 0
5 1 0 0 0 0 0 5 2 1
2 2 0 0 2 2
0 0 0 0 0 0
0 2 2 2 2 0
0 0 0 0 0 0
0 3 0 0 0 0
0 0 0 0 2 0
0 0 5 2 1 0 0 0
2 0 0 0 0 0
0 0 0 2 0 0
0 0 0 0 0 0
0 5 1 0 0 0 0 0
2 2 2 0 3 0
0 0 0 0 0 0
0 0 2 2 0 0
0 5 2 1 0 0 5 2 0 0
2 0 0 0 0 2
2 2 2 2 2 2






































